R 800 600
S ./text/barrel.xpm
NO ./text/clari.xpm
WE ./text/nat.xpm
SO ./text/tucos.xpm
EA ./text/dani.xpm

F  200,200,200
C  55,55,55

111111111111111
100000000000001
100000000000001
100000020000001
100000000000001
111110020000001
    100000000011111
    100000020000001
    100000000000001
    100000020000001
    100000000000001
    100000020011111
111110000000001
100000020000001
10S000000000001
100000020000001
100000000000001
100000020000001
100000000000001
100000020000001
100000000000001
1000000200000011
10000000000000011
10000000000000011
11111111111111111