R 800 600

NO ./text/walls/wall.xpm
WE ./text/walls/wall.xpm
EA ./text/walls/wall.xpm
SO ./text/walls/wall.xpm
D ./text/walls/door.xpm

F ./text/walls/grass.xpm
C 134, 172, 235

        1111111111111111111111111
        1000020000113000000000001
        1001000001110000003000001
        100100000008000N000000001
111111111001000001110000000004001
100000500001000001119111111111111
11110000000000011100000010001
11100111111111011101010310001
11000000110101000000000000001
10000004000000001100000010001
10000000000000001101010010201
110200011101310111110100100111
11110111111101011101111000001
11111111 1111111 111111111111