R 800 600

NO ./text/bendy/Wall.xpm
WE ./text/bendy/WallTear.xpm
EA ./text/bendy/Wall.xpm
SO ./text/bendy/Wall.xpm
D ./text/bendy/DoorNoBlurr.xpm

F ./text/walls/blackfloor.xpm
C 0, 0, 0

  111
 11211
 11011
11191111111111111111
150S0512000000500001
1000008000500000300111111111
1002001040000000000030000511
11111111111111100011111181111111
        105000011910030000000001
        100000000000000000005001
        111111111111111111111111